NO ./texture/north_wall.xpm
SO ./texture/south_wall.xpm
  C 225,30,0
WE ./texture/west_wall.xpm


F 220,100,0

EA ./texture/east_wall.xpm




1111111111111111111111111
1000001000110000000000001
1011000001110000000000001                             11111111111
10010N0000000000000000000111111111                     11100000001
111111111011000001110000000000001                    11 111111011
100000000011000001110111111111111                      1000000001
11110111110111011100000010001                          1111111111
11110111111111011101010000001
11000000110101011100000010001
10000000000000001100000010001
10000000000000001101010010001
1100000111010101111101110000011
11110111 1110001 101111010001
11111111 1111111 111111111111

11111111111111111111111
100000000000000001111111
10000000001111111
1111111111